###########
# $       #
######D####
#$       $#
#### ######
#### #    #
#### ######
# +  P    #
###########