###########
#         #
# .  #    #
#    #    #
######D####
# $    #  #
###### ####
#    P    #
###########