###########
#         #
##D########
#  $      #
########D##
#      $  #
# #########
#    P    #
###########