###########
#    $    #
#D#########
# $      $#
######D####
# $    +  #
####  #####
#    P    #
###########