###########
#         #
#  E   X  #
#         #
#  B      #
#         #
#         #
#    P    #
###########